##_______P
#_PPPp_A_#
___A___PPP
__ppp#_AP_
__##_PPP_#
_####_pB_P
____PPP_A_
__pPpP_##P
___AppP##P
__##_____P